!!ATOK_TANGO_TEXT_HEADER_1
!! 人名
はなみ	花海	固有名詞	
さき	咲季	固有名詞	
うめ	佑芽	固有名詞	
つきむら	月村	固有名詞	
てまり	手毬	固有名詞	
ふじた	藤田	固有名詞	
ことね	ことね	固有名詞	
ありむら	有村	固有名詞	
まお	麻央	固有名詞	
かつらぎ	葛城	固有名詞	
りーりや	リーリヤ	固有名詞	
くらもと	倉本	固有名詞	
ちな	千奈	固有名詞	
しうん	紫雲	固有名詞	
すみか	清夏	固有名詞	
しのさわ	篠澤	固有名詞	
ひろ	広	固有名詞	
ひめさき	姫崎	固有名詞	
りなみ	莉波	固有名詞	
しおり	汐莉	固有名詞	
はたや	秦谷	固有名詞	
みすず	美鈴	固有名詞	
じゅうおう	十王	固有名詞	
せな	星南	固有名詞	
くにお	邦夫	固有名詞	
かや	賀陽	固有名詞	
りんは	燐羽	固有名詞	
けい	継	固有名詞	
あまや	雨夜	固有名詞	
つばめ	燕	固有名詞	
ねお	根緒	固有名詞	
あさり	亜紗里	固有名詞	
ましろ	真城	固有名詞	
ゆう	優	固有名詞	

!! 地名等
はつぼしがくえん	初星学園	固有名詞	
あまがわ	天川	固有名詞	

!! 楽曲名
ふぁいてぃんぐまいうぇい	Fighting My Way	固有名詞	
るなせいめいびー	Luna say maybe	固有名詞	
せかいいちかわいいわたし	世界一可愛い私	固有名詞	
くらむじーとりっく	clumsy trick	固有名詞	
ためらいわんすてっぷ	Tame-Lie-One-Step	固有名詞	
こうけい	光景	固有名詞	
はくせん	白線	固有名詞	
わんだーすけーる	Wonder Scale	固有名詞	
ふろーらいと	Fluorite	固有名詞	
ざろーりんぐらいすぼーる	The Rolling Riceball	固有名詞	
ちいさなやぼう	小さな野望	固有名詞	
つきのかめ	ツキノカメ	固有名詞	

あいゔい	アイヴイ	固有名詞	
いえろーびっぐばん	Yellow Big Bang !	固有名詞	
ぶんぶんぱう	Boom Boom Pow	固有名詞	
こんとらすと	コントラスト	固有名詞	
ひびはっけんてきすてっぷ	日々、発見的ステップ！	固有名詞	
ふぃーるじゅえるどりーむ	Feel Jewel Dream	固有名詞	
えるゆーぶい	L.U.V	固有名詞	
かくしたわたし	カクシタワタシ	固有名詞	
きょっこう	極光	固有名詞	
あわちゃんと	Our Chant	固有名詞	

かなえたいことばかり	叶えたい、ことばかり	固有名詞	
うぇいくあっぷ	Wake up!!	固有名詞	
あこがれをいっぱい	憧れをいっぱい	固有名詞	
らいどおんびーと	Ride on Beat	固有名詞	
こすめてぃっく	Cosmetic	固有名詞	
めくるめ	メクルメ	固有名詞	
すうぃーとまじっく	Sweet Magit	固有名詞	
たいせつなもの	たいせつなもの	固有名詞	
まーぶるはーと	marble heart	固有名詞	
つよつよさいきょうえくささいず	つよつよ最強エクササイズ	固有名詞	
とらいいっとなう	Try it now	固有名詞	
ざきゅーと	The Cute!!!	固有名詞	

えご	EGO	固有名詞	
あんはっぴーらいと	Unhappy Light	固有名詞	
ふわふわ	ふわふわ	固有名詞	
とっぷしーくれっと	Top Secret	固有名詞	
ときめきのそるふぇーじゅ	ときめきのソルフェージュ	固有名詞	
こんてんぽらりのだんす	コンテンポラリのダンス	固有名詞	
うたごえはきみいろ	歌声は君いろ	固有名詞	
きらきら	Kira Kira	固有名詞	
ふらじーるはーと	Fragile Heart	固有名詞	

らぶあんどじょい	Love & Joy	固有名詞	
さんふぇーでっど	サンフェーデッド	固有名詞	
じここうていかんばくあげしゅきしゅきそんぐ	自己肯定感爆上げ↑↑しゅきしゅきソング	固有名詞	
さんじゅうろくどうぶ	36℃ U･B･U	固有名詞	

はじめ	初	固有名詞	
きゃんぱすもーど	Campus mode!!	固有名詞	
しるべ	標	固有名詞	

きみとせみぶるー	キミとセミブルー	固有名詞	
かむろぎく	冠菊	固有名詞	
かそうきょうそうきょく	仮装狂騒曲	固有名詞	
ほわいとないとほわいとうぃっしゅ	White Night! White Wish!	固有名詞	
はっぴーみるふぃーゆ	ハッピーミルフィーユ	固有名詞	
ゆきどけに	雪解けに	固有名詞	
さくらふぉとぐらふ	桜フォトグラフ	固有名詞	

がむしゃらにいこう	がむしゃらに行こう！	固有名詞	
はうりんぐおーばーざわーるど	Howling over the World	固有名詞	
みらくるななう	ミラクルナナウ(ﾟ∀ﾟ)!	固有名詞	
えんどれすだんす	ENDLESS DANCE	固有名詞	

ここんとうざいちょちょいのちょい	古今東西ちょちょいのちょい	固有名詞	

あめあがりのあいりす	雨上がりのアイリス	固有名詞	
すたーまいん	Star-mine	固有名詞	

すぷれましー	SUPREMACY	固有名詞	
れっつごーいちのに	Let's GO!! ICHI-NO-NI!!	固有名詞	
ないわ	ナイワ	固有名詞	




